Tunak Tunak Tun - Daler Mehndi
Why This Kolaveri Di - Dhanush
Jimikki Kammal - Vineeth Sreenivasan
It’s My Life (Funny Remix) - Indian Uncle Remix
Aathichudi (Remix) - Bharath
Selfie Pulla - Vijay
Zingaat - Sairat
Saami Saami - Pushpa
Chammak Challo - Akon & Hamsika
Rowdy Baby - Dhanush & Dhee
Lungi Dance - Honey Singh
Aa Ante Amalapuram - Arya
Tatti Tatti - Vennu Mallesh
Vande Mataram Trap Remix - Nucleya
Bhagat Singh Rap Remix - TikTok Meme
Let’s Nacho - Kapoor & Sons
DJ Waley Babu - Badshah
Genda Phool - Badshah
Bombay Theme - EDM Remix
Kala Chashma - Baar Baar Dekho
Baby Ko Bass Pasand Hai - Sultan
Nashe Si Chadh Gayi - Befikre
Taki Taki (Desi Mix) - DJ Notorious
Lehenga - Jass Manak
Morni Banke - Badhaai Ho
Swag Se Swagat - Tiger Zinda Hai
Kamariya - Stree
Malhari - Bajirao Mastani
Dil Chori - Sonu Ke Titu Ki Sweety
High Rated Gabru - Guru Randhawa
Kolaveri Di (Reverse) 
Indian Thriller - Baburao
Internet Ka Kaam - Vennu Mallesh
Aapka Kya Hoga - Dhanno Remix
Bhojpuri Twerking Mix - TikTok
Ghoomar Dubstep Version 
Indian Nyan Cat Remix 
Rasode Mein Kaun Tha - Kokilaben Remix
Bahubali Theme Dubstep 
Aye Hip Hopper (Old-school) 
Jai Ho - Slumdog Millionaire
Chaiyya Chaiyya - Dil Se
Badtameez Dil - Yeh Jawaani Hai Deewani
Tujh Mein Rab Dikhta Hai - Rab Ne Bana Di Jodi
Tere Liye - Veer-Zaara
Kal Ho Naa Ho - Kal Ho Naa Ho
Kabhi Khushi Kabhie Gham - Title Track
Mehndi Hai Rachnewali - Zubeidaa
Pehli Nazar Mein - Race
Tum Hi Ho - Aashiqui 2
Gerua - Dilwale
Aankh Marey - Simmba
Kaho Naa Pyaar Hai - Kaho Naa…
Dhoom Machale - Dhoom
Mauja Hi Mauja - Jab We Met
Desi Girl - Dostana
Gallan Goodiyan - Dil Dhadakne Do
Tera Hone Laga Hoon - Ajab Prem Ki Ghazab Kahani
Tareefan - Veere Di Wedding
Laung Da Lashkara - Patiala House
Nagada Sang Dhol - Ram-Leela
Dholi Taro Dhol Baaje - Hum Dil De Chuke Sanam
Radha - Student of the Year
Ghoomar - Padmaavat
Jai Jai Shivshankar - War
Bole Chudiyan - K3G
Albela Sajan - Hum Dil De Chuke Sanam
Deva Shree Ganesha - Agneepath
Om Jai Jagdish Aarti 
Aigiri Nandini - Traditional
Mundian To Bach Ke - Panjabi MC
Proper Patola - Diljit Dosanjh
Do You Know - Diljit Dosanjh
3 Peg - Sharry Mann
Laung Laachi - Neha Bhasin
Patiala Peg - Diljit Dosanjh
Illegal Weapon - Jasmine Sandlas
Lamborghini - Doorbeen
High Heels - Jaz Dhami & Honey Singh
Brown Munde - AP Dhillon
Tera Ban Jaunga - Kabir Singh
Hasi Ban Gaye - Hamari Adhuri Kahani
Sun Saathiya - ABCD 2
Raabta - Agent Vinod
Muskurane - CityLights
Tum Mile - Tum Mile
Jeene Laga Hoon - Ramaiya Vastavaiya
Bolna - Kapoor & Sons
Samjhawan - Humpty Sharma Ki Dulhania
Tujhe Kitna Chahne Lage - Kabir Singh
Bollywood vs EDM - DJ Chetas
T-Series Mixtape: Tera Chehra + Jaan Meri 
Coke Studio India: Afreen Afreen 
Kuthu Remix - Tamil Party Mix
Sufi EDM Mix - Nucleya
Indian Trap Mix - DJ Shadow Dubai
Dilliwaali Girlfriend - Yeh Jawaani Hai Deewani
Ghagra - Yeh Jawaani Hai Deewani
Saudagar Sauda Kar (Remix) 
Vande Mataram - A.R. Rahman